Transaction Type,Amount,Balance After Transaction
deposit,500,500
withdraw,100,400
crypto,20,420
cash,50,370
Withdraw,£2.00,£368.00
Deposit,£200.00,£568.00
Withdraw,£100.00,£468.00
Deposit,£2.00,£470.00
